1111111111111111111111111111111111111111111111111111111111111111111111111111111111111111111111111111
1000001010000010001000100000001000000200001010100010100000000010101000000000100010001000100000020011
1110111010101110111011101110111111101111111010101010111111101110101010111011101110101110111111111011
1000000000100000000000100010100000100010001000001000001000100010100010100000000010100010000010000011
1111111111101011111011111011101011101111101111111011111011101110111011101011111011101010111010111111
1000001010101010000010100000101010000010000000100000000000000010000010101000001000001000001000001011
1011111010101111111110101110111011101110111010111110111111111011111010101111111011111011111011111011
1000100000100000000000101010000010000000100010100010000000100000101010001010101010000010100010101011
1011101110111011111110101011111010101010111110101111111011101011101111101010101011111110101010101011
1000001010001000000010001000001010101010001010001010101000101010001010100000001000001000001000000011
1110111010101011101011111011111010101011111011101010101111101111101010101010111011111111101110101011
1000001000100000101010000000001010101010000000001000001000000000000000001010101000001010001000101011
1111111110111111111011101110111011111111101010111110111111101111111110101010101010111010101010101111
1000100000100010001000101000101000001000101010101010000000000000001000101010100010101010101010101011
1011111111101110111010101111101110111011101111101011111110101110101110111010111011101011111010101011
1000100000000200000010101000001000100000000010000010000000100010101010100010101010001000101010101011
1011101011111111111010101110111011111010101110111110111111111111101011101110101111101010101110111011
1000001010001010000010000000101010000010100010100010100000100000000010001000001010000010101000100011
1011111010111010101011111111101110101110101010101110111011101011111011111111101010111011101110101011
1010000010000010101000001010001010101000101000001010100000101000001000000010001000001000100010001011
1111111010111010101110111011101010111110101011111010111110111110111010101111111110111110101110101111
1010000010001010101010000010001000001000101000100010000000101010100010100010100010001000001000100011
1010111011111010111011101110111110111111111011101111101111101011101011111110111011101111101111101111
1000101000101000001010100000000010100000020000000000000000100010101010001000000000101000000000000011
1110101011101110111010111111101111111111101110111111111111101010111110101011101011111111101111101111
1000100000001000001000001000000000001000001000001000000000101000101000100010001010000000101010000011
1110111110111111101011101010101010111010101110101110111011111110101110111011101110101110101011111011
1000100000100000000010001010101010000010101000100000001000000000000000001000100010101000000000100011
1111111111111111111111111111111111111111111111111111111111111111111111111111111111111111111111111011
1111111111111111111111111111111111111111111111111111111111111111111111111111111111111111111111111311